#####################
#P#.....C...........#
#.#.######.######.#M#
#.#.#.C.........#.#.#
#.#.#.#########.#.#.#
#.#.#.#U..M....C#.#.#
#.#.#.#.#######.#.#C#
#.#C#.#.#.....#.#.#.#
#...#.#.#.###.#C#.#.#
#.#M#.#.#.#C#.#.#.#.#
#.#.#.#C#.#.#.#.#.#.#
#U..#.#.#...#.#.#.#.#
#####.#.#####.#.#.#C#
#..C..#.......#.#.#.#
#.#############.#.#.#
#.....C.........#E..#
#####################