#####################
#...............#...#
#.#.M.#.#.#...#.#.#.#
#.#.#.#.#.#.#.#.#.#.#
#.#.#.#.#.#.#.#.#.#.#
#.#.#.#.#.#.#.#.#.#.#
#.#.#.#.#.#.#.#.#.#.#
#.#.#.#.#.#.#.#.#.#.#
#.#..M#U#.#...#.#.#.#
#.#C###.#.#.###.#.#M#
#C....P.#...#.C..E.##
#####################
