#####################
#P...#...#...#...#..#
#.#.#.#.#.#.#.#.#.#.#
#.#.C.#...#C..#...#.#
#.#############.###.#
#.#...#...#...#...#.#
#.#.#.#.#.#.#.###.#.#
#C..#...#...#..C..#.#
#.###.#####.#######.#
#.#...#.U.#.......#.#
#.#.###.#.#######.#.#
#.#.#...#.......#.#.#
#.#.#.#########.#.#.#
#.#C..#.......#.#.#.#
#.#####.#####.#.#.#.#
#.......#EC.....#...#
#####################