#####################
#P.........#.....C..#
#.#######.###.#####.#
#.#..C..#.#U#.#...#.#
#.#.###.#.#.#.#.#.#.#
#.#.#E#.#.#.#.#.#.#.#
#.#.#.#.#...#.#.#.#.#
#.#.#.#.#####.#.#.#.#
#.#.#.#...M...#.#C#.#
#.#.#.##.###.##.#.#.#
#.#.#.....C.....#.#.#
#.#.#############.#.#
#.#....C..........#.#
#.#################.#
#...................#
#M....#C..#...#C..U.#
#####################