#####################
#P..................#
#.########.########.#
#.#............C..#.#
#.#.#############.#.#
#.#.#...........#.#.#
#.#.#.#########.#.#.#
#.#...#U......#.#.#.#
#.#.#.###.###.#.#.C.#
#.#.#.......#.#.#.#.#
#.#.#######.#.#.#.#.#
#.#.......#.#M#.#.#.#
#.#######.#.###.#.#.#
#.......#.#.C...#.#.#
#######.#.#######.#.#
#E..C.............#.#
#####################