#####################
#P..C...#...........#
#.#####.#.#########.#
#.....#.#.#.......#.#
#####.#.#.#.#####.#.#
#...#.#.#.#.#...#.#.#
#.#.#.#.#.#.#.#.#.#.#
#.#.#.#.#.#.#.#.#.#.#
#.#.....M.....#...#.#
#.#########.#######.#
#.........#.........#
#.#######.#.#######.#
#.#.....#.#.#.....#.#
#.#.###.#M#.#.###.#.#
#...#UC...#...#E..#.#
#####################