#####################
#P..................#
#.#####.#######.####.#
#.#...#.#.....#....#.#
#.#.#.#.#.###.####.#.#
#.#.#.#.#.#U#....#.#.#
#.#.#.#.#.#.####.#.#.#
#.#.#.#.#.#....#.#.#.#
#.#.#.#.#.####.#.#.#.#
#.#.#.#.#....#.#.#.#.#
#.#.#.#.####.#.#.#.#.#
#.#.#.#....#.#.#.#.#.#
#.#.#.####.#.#.#.#.#.#
#.#.#....#.#.#.#.#.#.#
#.#.####.#.#.#.#.#.#.#
#...#CM..#...#...#E.#
#####################